#############################################
#                        #                  #
#         P              #                  #
#                                O          #
#   X                    #                  #
#                        ##############     #
#############################################